0	0	0	0	0	0	0	15	16	0
0	0	0	0	0	0	0	14	0	0
1	0	1	8	9	10	10	1	14	20
48	0	5	0	0	0	0	15	0	22
44	0	4	0	28	1	20	1	25	1
42	40	1	0	28	0	0	15	0	25
0	0	3	0	30	0	0	1	15	26
0	0	1	0	32	0	0	0	0	27
0	0	28	0	32	28	1	30	30	27
0	0	30	0	0	0	35	0	0	0
0	0	1	33	38	35	35	0	0	0
